111111111111111111111111111111
10000000000000000000C0100000C1
100011111111111111100010000001
100010000000000000000010000001
100010001111111111111110000001
100010000000000000000000000001
100011111111111111111110000001
1P00000000000000000000000000X1
111111111111110111110010011111
100000010000000000010010000001
100C00010000000000010011111001
100000010000000000000010000001
100001010000000000000010111111
100010110011111110000010000001
100000000100000000000011111001
1000000001000C000000001000C001
111111111111111111111111111111