1111111111111111111111
10000001C0000000000001
1000000100000X10000001
1P00111100000010000C01
1000000000000000X00001
1000111111111001111C01
10001000000000000000X1
10001000C00000000000E1
1111111111111111111111