0111111111111111111111
10000001C0000000000001
1000000100000010000001
1000111100000010000C01
1P00000000000000X00001
1P00000000000000X00001
1P00000000000000X00001
1P00000000000000X00001
1000111111111001111C01
1000100000000000000001
10001000C0000000000000
1111111111111111111111
0