111111111
1P0011111
111100001
1C00000E1
111111111