111111111
10P0C0E01
1000000X1
111111111